   SO        ./textures/bluestone.xpm    
EA ./textures/eagle.xpm
NO      ./textures/greystone.xpm
WE ./textures/purplestone.xpm

C 52,12,223
F 179,179,50

111111111111111111111111111111
100000000000000000000000000001
100000000000000N00000000000001
100000000000000000000000000001
100000000000000000000000000001
100000000000000100000000000001
100000000000001 110000000000001
100000000000001110000000000001
100000000000000001110000000001
100000000000000001110000000001
100000000000000000000000000001
100111111111111111111100000001
11111                111111111