EA ./textures/eagle.xpm
NO      ./textures/greystone.xpm
SO      ./textures/bluestone.xpm
WE ./textures/purplestone.xpm

C 52,126,12
F 179,179,138


        111111111111111111111
        100000000011000000001
        1011000001110000E0001
        100100000000000000101
        100000001111000001001
11111111101100000111000000001
10000000001100000111011110111
11110111111111011100000010001
11110111111111011101010010001
11000000000000011100001000001
10000010000000000000000000001
10001010000000001101010010001
11000101110101011111011110001
11110111 1110101 101111010111
11111111 1111111 111111111111