
SO      ./textures/bluestone.xpm
EA ./textures/eagle.xpm
NO      ./textures/greystone.xpm
WE ./textures/purplestone.xpm

C 52,126,
F 179,179,108          


1111111111111111111111111111111111111111111111111111111111111
11000000N0000000000000000000000000000000000000000000000000001
1100000000000000000000000000000000000000000000000000000000001
1100000000000000000000000000000000000000000000000000000000001
1100000000000000000000000000010000000000000000000000000000001
1100000000000000000000000000001000000000000000000000000000001
1100000000000000000000000000000000000000000000000000000000001
1100000000000000000000000000000000000000000000000000000000001
1100000000000000000000000000000000000000000000000000000000001
1100000000000000000000000000000000000000000000000000000000001
1111111111111111111111111111111111111111111111111111111111111